まよあお	青	人名
まよあきら	明	人名
まよあずさ	梓	人名
まよあまね	天葉	人名
まよあんず	杏	人名
まよあんずみせ	月桂堂	人名
まよいざよい	伊邪宵	人名
まよいとめ	糸目	人名
まようる	ウル	人名
まよえん	円	人名
まよおりべ	織部	人名
まよかがり	炬	人名
まよかしか	カシカ	人名
まよかすり	綛	人名
まよかたなし	形無	人名
まよかなべ	鼎	人名
まよかなめ	要	人名
まよかむい	神威	人名
まよききょう	喜鏡	人名
まよきゃんでぃ	キャンディ	人名
まよきよら	清ら	人名
まよくれは	紅葉	人名
まよくろさめ	黒雨	人名
まよけいと	圭人	人名
まよげんげ	紫雲	人名	
まよこうすけ	幸介	人名
まよこえだ	小枝	人名
まよこころ	心	人名
まよこてつ	コテツ	人名
まよこまいぬ	狛犬	人名
まよささめ	紗々芽	人名
まよさほ	佐保	人名
まよさよ	咲夜	人名
まよしお	梓緒	人名
まよしゅう	柊	人名
まよじゅうごの	襲護	人名
まよしらひ	シラヒ	人名
まよしるべ	瑞紅	人名
まよしるべ	標	人名
まよしろいったん	白一反	人名
まよしんく	真紅	人名
まよすい	透伊	人名
まよすずなり	鈴鳴	人名
まよすぴねる	スピネル	人名
まよせいご	清護	人名
まよせつか	雪華	人名
まよせる	世路	人名
まよせん	旋	人名
まよそうた	草太	人名
まよそら	奏夢	人名
まよだきにのみこと	荼枳尼尊	人名
まよだにえる	ダニエル	人名
まよたま	珠	人名
まよたまき	環	人名
まよちかぜ	千風	人名
まよちゆき	千雪	人名
まよつくも	津雲	人名
まよつづり	綴	人名
まよつむぎ	紡	人名
まよとうか	藤花	人名
まよとおま	壱拾真	人名
まよとばり	帳	人名
まよとびお	鳶尾	人名
まよなつ	ナツ	人名
まよなでしこ	撫子	人名
まよにすけ	仁助	人名
まよぬえ	鵺	人名
まよのあし	野葦	人名
まよのなか	野中	人名
まよのら	ノラ	人名
まよはく	ハク	人名
まよはくと	白兎	人名
まよはくも	白雲	人名
まよはしばみ	榛	人名
まよはっか	薄荷	人名
まよはなぎし	ハナギシ	人名
まよはなまり	花毱	人名
まよひさめ	氷雨	人名
まよひさめ	霈	人名
まよひな	雛	人名
まよびゃくら	白楽	人名
まよふたなり	双成	人名
まよべにお	紅緒	人名
まよほあお	一色青	人名
まよほあきら	蔵元 明	人名
まよほあまね	三束 天葉	人名
まよほいとめ	糸目月望水主命	人名
まよほうる	ウル・ノルン	人名
まよほおもいかね	思金神	人名
まよほかむい	水地 神威	人名
まよほきゃんでぃ	キャンデス・レモン	人名
まよほきよら	豊美玉清彦	人名
まよほけいと	津下 圭人	人名
まよほげんげ	紫雲英白虹尊	人名
まよほこうすけ	桐谷 幸介	人名
まよほこえだ	田村 小枝	人名
まよほこころ	相羽 心	人名
まよほささめ	佐々木 紗々芽	人名
まよほしお	五十鈴梓緒	人名
まよほしぐれ	鳥生 時雨	人名
まよほじゅうごの	双天竜襲護命	人名
まよほすい	井ノ本 透伊	人名
まよほすぴねる	猫神スピネル	人名
まよほせいご	双天龍清護命	人名
まよほせる	セルペンテ	人名
まよほそうた	人里 草太	人名
まよほそら	相川 奏夢	人名
まよほだにえる	榊原ダニエル	人名
まよほちゆき	九条千雪	人名
まよほつむぎ	娥 紡	人名
まよほとうか	白木 藤花	人名
まよほとびお	来鳥鳶尾	人名
まよほなでしこ	河原 撫子	人名
まよほにしき	衣田 にしき	人名
まよほぬえ	鵺大明神	人名
まよほのなか	野中みふゆ	人名
まよほはくと	白兎神	人名
まよほひな	瑠璃雛菊	人名
まよほふたなり	由利谷 双成	人名
まよほみこさき	神子崎 啓治	人名
まよほみづち	因果見贄螭	人名
まよほむすび	娥 結	人名
まよほゆきのえ	高龗神 雪之会	人名
まよほよい	望月 宵	人名
まよほよみ	雨宮 詠	人名
まよほりお	天野 莉桜	人名
まよほれいと	神無　零斗	人名
まよほをそ	天獺彦大御神	人名
まよほをそに	天之男祖日子大御神	人名
まよましろ	万白	人名
まよみけ	ミケ	人名
まよみこさき	ミコサキ	人名
まよみづち	ミヅチ	人名
まよむすび	結	人名
まよむめい	無銘	人名
まよめい	鳴	人名
まよめらん	芽蘭	人名
まよやなぎ	柳	人名
まよゆきのえ	雪之会	人名
まよゆずき	柚鬼	人名
まよよい	宵	人名
まよよみ	ヨミ	人名
まよよみ	詠	人名
まよりお	莉桜	人名
まよるるぅ	ルルゥ	人名
まよをそ	獺神	人名
